XXXXX
X   X
X   X
XXXXX
XXXXX
XXXXX
XXXXX
XXXXX
XX XX